11111111
10000011
10P0C0E1
10C01101
10C00001
11111111
