11111111
11100001
11P0C1E1
11C01111
10C00001
11111111
