1111111
1000001
1P0C0E1
1C01101
1C00001
1111111
