111111111111111
1P0000000000001
101110111011101
100010000010001
111010111010111
1C00001000000C1
101111011101101
1E0000000000001
111111111111111
